NO ./textures/LAB_1A.xpm
SO ./textures/LAB_4A.xpm
WE ./textures/TECH_0A.xpm
EA ./textures/SUPPORT_6A.xpm
DO ./textures/door.xpm

C 53, 131, 148
F 99, 71, 40

        1111111111111111111111111
        1000000000110000000000001
        1011000001110000000000001
        1001000000000000000000001
111111111011000001110000000000001
100000000011000001110111111111111
11110111111111011100000010001
11110111111111011101010010001
11000000110101011100000010001
10000000000000001100000010001
10000000000000001101010000001
11000001110101011111011111D1111
11110111 10000101 100001010001
11110111 10000101 100001010N01
11110111 10000101 100001010001
11111111 1111111 111111111111
