
NO ./textures/LAB_1A.xpm
SO ./textures/LAB_4A.xpm
WE ./textures/TECH_0A.xpm
EA ./textures/SUPPORT_6A.xpm
DO ./textures/door.xpm

C 53, 131, 148
F 99, 71, 40

1111111111111111111111111111111111111111111
1000000000110000000000000000000000000000001
1011000001110000011110000111000000110000001
1001000000000000010000000100000000100000001
1111111110110000011100000011100000011100001
1000000000110000011101111111111111111110001
1111011111111101110000001000000000000000001
1111011111101101110101001000111111000000011
111101111110110111010100100010D00100000011
1111011111101101110101001000111111000000011
1111011111101101110101001000000001000010011
1111011111101101110101001000000001000010011
1111011111101101110101001000000001000010011
1111011111101101110101001000000001000010011
1111011111101101110101001000000001000010011
1111011111101101110101001000000001000010011
1111011111101101110101001000000001000010011
1111011111101101110101001000000001000010011
1111011111101101110101001000000001000010011
1111011111101101110101001000000001000010011
1111011111101101110101001000000001000010011
1111011111101101110101001000000001000010011
1111011111101101110101001000000001000010011
1111011111101101110101001000000001000010011
1111011111101101110101001000000001000010011
1111011111101101110101001000000001000010011
1111011111101101110101001000000001000010011
1111011111101101110101001000000001000010011
1111011111101101110101001000000001000010011
1111011111101101110101001000000001000010011
111101111110110111010100100000000111D110111
1111011111101101110101001000000001000010011
1111011111101101110101001000000001000010011
1111011111101101110101001000000001000010011
1111011111101101110101001000000001000010011
1111011111101101110101001000000001000010011
1000000000000000110000001000000000000000001
1000000000000000110101000000001111111111111
11000001110101011111111111D1111000000000001
1111011111000010110000010000100000100001001
1111011111000010110001010000100000100001001
11110111110000100000010000000000001000010N1
1111111111111111111111111111111111111111111
