NO ./textures/LAB_1A.xpm
SO ./textures/LAB_4A.xpm
WE ./textures/TECH_0A.xpm
EA ./textures/SUPPORT_6A.xpm
DO ./textures/door.xpm

C 53, 131, 148
F 99, 71, 40

1111111111111111111111111
1000000000010000000000001
10000000001DN000000000001
1000000000010000000000001
1000000000000000000000001
1000000000000000000000001
1000000000000000000000001
1000000000000000000000001
1111111111111111111111111
