NO ./textures/LAB_1A.xpm
SO ./textures/LAB_4A.xpm
WE ./textures/TECH_0A.xpm
EA ./textures/SUPPORT_6A.xpm
DO ./textures/door.xpm

F 220,100,0
C 225,30,0

1111111111111111111111111
1000000000010000000000001
10000000001D0000000N00001
1000000000010000000000001
1000000000000000000000001
1111111111111111111111111
