NO ./textures/LAB_1A.xpm
SO ./textures/LAB_4A.xpm
WE ./textures/TECH_0A.xpm
EA ./textures/SUPPORT_6A.xpm
DO ./textures/door.xpm
TO ./textures/torch.xpm
TA ./textures/attack_torch.xpm

F 220,100,0
C 225,30,0

1111111111111111111111111
1000000000000000000000001
10T000000001D00000T0N00001
1000000000000000000000001
1000000T00000000000T00001
1111111111111111111111111
